{
name: 1_ivory_tower
width: 9
height: 9
plan.types: [
	"L L L L L L L L L "
	"L L L L L L L L L "
	"L L L L L L L L L "
	"L L L L L L L L L "
	"L L L L L L L L L "
	"L L L L L L L L L "
	"L L L L L L L L L "
	"L L L L L L L L L "
	"L L L L L L L L L "
]
plan.letters: [
	"- - - - - - - - - "
	"- - - - - - - - - "
	"- - - - - - - - - "
	"- - - - - - - - - "
	"- - - - - - - - - "
	"- - - - - - - - - "
	"- - - - - - - - - "
	"- - - - - - - - - "
	"- - - - - - - - - "
]
plan.powers: [
	"1 1 1 1 1 1 1 1 1 "
	"1 1 1 1 1 1 1 1 1 "
	"1 1 1 1 1 1 1 1 1 "
	"1 1 1 1 1 1 1 1 1 "
	"1 1 1 1 1 1 1 1 1 "
	"1 1 1 1 1 1 1 1 1 "
	"1 1 1 1 1 1 1 1 1 "
	"1 1 1 1 1 1 1 1 1 "
	"1 1 1 1 1 1 1 1 1 "
]
plan.owners: [
	"0 0 0 0 0 0 0 0 1 "
	"0 0 0 0 0 0 0 0 0 "
	"0 0 0 0 0 0 0 0 0 "
	"0 0 0 0 0 0 0 0 0 "
	"0 0 0 0 0 0 0 0 0 "
	"0 0 0 0 0 0 0 0 0 "
	"0 0 0 0 0 0 0 0 0 "
	"0 0 0 0 0 0 0 0 0 "
	"2 0 0 0 0 0 0 0 0 "
]
plan.zones: [
	"1 1 1 1 - 2 2 2 2 "
	"1 1 1 1 - 2 2 2 2 "
	"1 1 - - - - - 2 2 "
	"1 1 - 5 5 5 - 2 2 "
	"- - - 5 5 5 - - - "
	"4 4 - 5 5 5 - 3 3 "
	"4 4 - - - - - 3 3 "
	"4 4 4 4 - 3 3 3 3 "
	"4 4 4 4 - 3 3 3 3 "
]
}